{
	"enemies" : [
		{
			"type" : 0,
			"x" : 5,
			"y" : 7
		},
		{
			"type" : 0,
			"x" : 3,
			"y" : 2
		},
		{
			"type" : 0,
			"x" : 1,
			"y" : 10
		},
		{
			"type" : 0,
			"x" : 3,
			"y" : 2
		},
			{
			"type" : 1,
			"x" : 1,
			"y" : 11
		},
		{
			"type" : 1,
			"x" : 4,
			"y" : 1
		}
	],
	"player" : {
		"x" : 5,
		"y" : 3
	},
	"particles" : [{
			"x" : 5,
			"y" : 6
		},
		{
			"x" : 4,
			"y" : 2
		},
		{
			"x" : 5,
			"y" : 5
		},
		{
			"x" : 2,
			"y" : 11
		}
	],
	"map" : [[20, -1, 20, 20, 42, 20, 21,  1,  1,  2,  0,  0,  0,  3, -1],
			 [20, 18, 42, 20,  1,  1, 20,  4,  5, 20, 20, 42, 20, 20, 18],
			 [ 0,  1,  0, 22,  0,  0, 20, 20, -2, -3, -4, -5,  7,  7,  7],
			 [20,  0, 23, 40, 23, 20, 20, 20, -6, -7, -8, -9, 12, 20, 20],
			 [24, 20,  0, 41,  6, 20,  7, 25, 13, 14, 15, 16, 12, 20, 23],
			 [26, 25, 20, 20, 20, 20, 12, 20, 29, 30, 31, 32, 33, 34, 35],
			 [27, 24, 20, 20, 28,  1, 17,  1, 20, 20, 20, 20, 12, 20, 20],
			 [ 7,  7,  7,  7,  7,  7, 12,  7,  7, 36,  7,  7, 12,  7,  7],
			 [12, 12, 12, 12, 12, 12, 12, 37, 38, 38, 38, 39, 12, 12, 12],
			 [ 8,  8,  8,  8,  8,  8,  8, 9, 10, 10, 10, 19, 12, 12, 12]
			]
}